  XXXXXXXXX   XXXXXXXXX
X XXXXXXXXX X   XXXXXXX
X   XXXXXXX XXX XXXXXXX
XXX XXXXXX  XXX XXXXXXX
XXX    XX  XXXX     XXX
XXX XX X  XXXXX XXX XXX
XXXXXX X XX  XX   XXXXX
XXXXXX X XX XXX XXXXXXX
XX XXX XXXX XXXXXX    X
XX     XX    XXXX  XX X
XX XXXXXX XX XXXX XXX X
XX   XX   XX      XXXXX
XXXX    XXXXXXXXXXXXXDX