  XXXXXXXXX   XXXXXXXXX
  XXXXXXXXX X   XXXXXXX
    XXXXXXX XXX XXXXXXX
 XXxXXXXXX  XXX XXXXXXX
 XX        XXXX     XXX
 XX XX X  XXXXXXXXX XXX
 XXXXX X XX  XX     XXX
 XXXXX X XX XXX XXXXXXX
 X XXX XXXX XXX       X
 X     XX    XXXX  XX X
 X XXXXXX XX XXXXXXXX X
 X   XX   XX      XXX X
   X    XXXXXXXXXXXXXDX