               XXXXX
XXXXXXXXXXX X   XXXX
X   XXXXXXX XXX XXXX
XXX XXXXXX  XXX XXXX
XXX    XX  XXXX     
XXX XX X  XXXXX XXX 
XXXXXX X XX  XX   XX
XXXXXX   XX XXX XXXX
XX XXX XXXX XXXXXX X
XX     XX    XXXX  X
XX XXXXXX XX XXXX XX
XX   XX   XX      XX
XXXX    XXXXXXXXXDXX